-12
12
-5
7
0000000000000000000000000
0000000000000000000000000
0000000000000111111100000
0000000000000111111110000
0000000000000111111100000
0000010000000111111100000
0000000000000111111100000
0000000000000111111100000
0000000000000111111100000
0000000100000000000000000
0000000000000000000000000
0000000000000000000000000
0000000000000000000000000
