-7
9
-2
6
00000000000000000
00000011111110000
00000011111110010
00000011111110000
10000011111110000
00000011111110000
00000011111110000
00000011111110000
00100000000000000
